rows 29
cols 39
players 2


m %%%%%%%%%%%%%%%%%%%%%%%%%%%%%%%%%%%%%%%
m %%%%%.............%b%.............%%%%%
m %%%%%.............%%%.............%%%%%
m %%%%%.............................%%%%%
m %%%%%.............................%%%%%
m %%%%%.............................%%%%%
m %%%%%.............................%%%%%
m %%%%%..............1..............%%%%%
m %%%%%..............0..............%%%%%
m %%%%%.............................%%%%%
m %%%%%.............................%%%%%
m %%%%%.............................%%%%%
m %%%%%............%...%............%%%%%
m %%%%%.............%%%.............%%%%%
m %%%%%.............................%%%%%
m %%%%%.............%%%.............%%%%%
m %%%%%............%...%............%%%%%
m %%%%%.............................%%%%%
m %%%%%.............................%%%%%
m %%%%%.............................%%%%%
m %%%%%..............a..............%%%%%
m %%%%%.............aaa.............%%%%%
m %%%%%.............aa..............%%%%%
m %%%%%.............................%%%%%
m %%%%%.............................%%%%%
m %%%%%.............................%%%%%
m %%%%%.............................%%%%%
m %%%%%.............................%%%%%
m %%%%%%%%%%%%%%%%%%%%%%%%%%%%%%%%%%%%%%%
