rows 37
cols 61
players 4

m %%%%%...........%%%%%%%...............%%%%%%%...........%%%%%
m %%%%%...................................................%%%%%
m %%%%%...................................................%%%%%
m %%%%%...................................................%%%%%
m %%%%%...................................................%%%%%
m %%%%%...................................................%%%%%
m %%%%%...................................................%%%%%
m %%%%%...................................................%%%%%
m %%%%%...................................................%%%%%
m %%%%%...................................................%%%%%
m %%%%%...................................................%%%%%
m %%%%%..............B.....................C..............%%%%%
m %%%%%...................................................%%%%%
m %%%%%.........................%.........................%%%%%
m %%%%%.........................%.........................%%%%%
m %%%%%.........................%.........................%%%%%
m %%%%%.........................%.........................%%%%%
m %%%%%.........................%.........................%%%%%
m %%%%%.................%%%%%%%%%%%%%%%%%.................%%%%%
m %%%%%.........................%.........................%%%%%
m %%%%%.........................%.........................%%%%%
m %%%%%.........................%.........................%%%%%
m %%%%%.........................%.........................%%%%%
m %%%%%.........................%.........................%%%%%
m %%%%%...................................................%%%%%
m %%%%%..............A.....................D..............%%%%%
m %%%%%...................................................%%%%%
m %%%%%...................................................%%%%%
m %%%%%...................................................%%%%%
m %%%%%...................................................%%%%%
m %%%%%...................................................%%%%%
m %%%%%...................................................%%%%%
m %%%%%...................................................%%%%%
m %%%%%...................................................%%%%%
m %%%%%...................................................%%%%%
m %%%%%...................................................%%%%%
m %%%%%...........%%%%%%%...............%%%%%%%...........%%%%%