rows 13
cols 19
players 2


m %%%%%%%%%%%%%%%%%%%
m %%%%%...%b%...%%%%%
m %%%%%...%%%...%%%%%
m %%%%%%%%%%%%%%%%%%%
m %%%%%%%%%%%%%%%%%%%
m %%%%%.........%%%%%
m %%%%%....1....%%%%%
m %%%%%.........%%%%%
m %%%%%....A....%%%%%
m %%%%%.........%%%%%
m %%%%%.........%%%%%
m %%%%%.........%%%%%
m %%%%%%%%%%%%%%%%%%%
